1111111111111111111111111111111111111111111111
1P0000000000000000000000C00000C000000000000001
1000000000000000000000000000000000000000000001
1000000000000000000000000000000000000000000001
1000000000000000000010000000001000000000000011
1000000000000000000000000000000000000000000001
1000000000000000000000000000000000000000000001
1000000000000000000000000000000000000000000001
1000000000000000000000000000000000000000000001
1000000000000000000000000000000000000000000001
100000000000000000000000000C0000C00000000000E1
1111111111111111111111111111111111111111111111